~~~~~~________?...._______E_F
__~~~~~_______________....~~_
____~~~~~~~_________..__E~~__
__________~~~~_________~~____
__________~~~~__E______~~~~__
___________[[[[E_____[[..__..
___________~~~~~~~_______?...
_T_______E____~~~~____E______
_EF____________~~~___________
_?_____________~~~~~________T