~~~~~~________?...._______E_F
__~~~~~_______________....~~_
____~~~~~~~_________..__E~~__
__________~~~~_________~~____
__________~~~~__E______~~~~__
___________[[[[E_____[[..__..
___________~~~~~~~_______?...
_E_______E____~~~~____E______
_______________~~~___________
_?_____________~~~~~________T